NO ./img/wall1.xpm
SO ./img/wall2.xpm
WE ./img/wall3.xpm
EA ./img/wall4.xpm

F 220,100,0
C 225,30,0

        1111111111111111111111111
        1000000000110000000000001
        1011000001110000000000001
        1001000000000000000000001       
111111111011000001110000000000001
100000000011000001110011111111111
11110111111111011100000010001
111101111 1111011101010010001
11000000110101011100100010001                           11111111
10000000000000001101 10010001                           11110001
10000000000000001101110010001                           11111111
11000001110101011111011110N01
11110111 1110101 101111010001
11111111 1111111 111111111111
 