NO ./img/wall1.xpm
SO ./img/wall2.xpm
WE ./img/wall3.xpm
EA ./img/wall4.xpm

F 220,100,0
C 225,30,0

11111111111111111111111
1P000000000000000000001
10000000000000000000001
10000000000000000000001
10000000000000000000001
10000000000000000000001
10000000000000000000001
10000000000000000000001
10000000000000000000001
10000000000000000000001
10000000000000000000001
10000000000000000000001
10000000000000000000001
10000000000000000000001
11111111111111111111111