NO ./img/wall1.xpm
SO ./img/wall2.xpm
WE ./img/wall3.xpm
EA ./img/wall4.xpm

F 50,50,50
C 255,255,255

111111111111111111111111111111
100000000000000000000000000001
10000000000000000000000P000001
100000111111000001111100000001
100000100001000001000010000001
100000100001000001000010000001
100000111111000000000010000001
100000000000000000000010000001
100000000000001111111110000001
100000111000000000000000000001
100000111000000000000000000001
100000000000000111000000000001
100000000000000111000000000001
100000111111000000000000000001
100000100000000000001111100001
100000100000N00000001000100001
100000111111000000001000100001
100000000000000000001111100001
100000000000000000000000000001
111111111111111111111111111111
