NO ./img/wall1.xpm
SO ./img/wall2.xpm
WE ./img/wall3.xpm
EA ./img/wall4.xpm

F 50,50,50
C 255,255,255

        1111111111111111111111111
        1000000000110000000000001
        10110000011100000P0000001
        1001000000000000000000001
111111111011000001110000000000001
100000000011000001110111111111111
11110111111111011100000010001
11110111111111011101010010001
11000000110101011100000010001
10000000000000001100000010001
10011D11000000000001101010011
11000001110101011111011110N01
11110111111010111101010010001
11111111 1111111 111111111111